
NO ./Bonus/assets/wall1.xpm
SO ./Bonus/assets/wall2.xpm
WE ./Bonus/assets/wall4.xpm
EA ./Bonus/assets/wall3.xpm
   
F 70,0,0
C 29,29,28
    
				        
111111111111111   11111111111111111
10011111101111111111111111000001
10001    10000000000000000111111                                              1
11011    111111111111001121                                                 110111
100011111110000000000000001                                                10000001
100010000110111111111111111111111111111111                                1000000001
1000000001101               1000000000001                                100000000001
1000100001101               1000000000001111111111111111111111111111111110000000000001
100011111112111111          10000000000020000000000000000000000000000000200000030000111
100011000000000001          1000101000001111111111111111111111111111111110000000000001
100011000000000001          1000010100001                                100000000001
10001100000000000111111111111000000000001                                 1000N00001
10000200000000000200000000000000011111111                                  10000001
1000110000000000011111111111111011                                          111111
1111111101111111111111111111111111
        1