NO ./assets/wall1.xpm
SO ./assets/wall2.xpm
WE ./assets/wall4.xpm
EA ./assets/wall3.xpm
DO ./assets/door.xpm
   
F 70,77,79
C 29,29,28
    
				        
11111111111111111111111111111111
10011111101111111111111111000001
10001    10000000000000000111111
11011    111111111111001121                           111111
100011111110000000000000001                          10000001
10001000011011111111111111111111111111111           1000000001
1000000001101               1000000000001          100000000001
1000100001101               100000000000111111111110000000000001
100011111112111111          1000000000002000000000200000000000111
100011E00003000001          100010100000111111111110000000000001
100011000003000001          1000010100001          100000000001
10001100000000000111111111111000000000001           1000000001
10000200000000000200000000000000011111111            10000001
1000110000000000011111111111111011                    111111
1111111101111111111111111111111111
        1