NO ./Bonus/assets/wall1.xpm
SO ./Bonus/assets/wall2.xpm
WE ./Bonus/assets/wall4.xpm
EA ./Bonus/assets/wall3.xpm

C 100,101,20
F 91,95,144


1111111111111111111111111111111111111111111111111111111111
11000000110110000001100000000000000000110000000000000000011
11000110000110000001100000000000111111110000010000000000011
11000111111111000001111111100000110000000000010000000000011
10000000000000100000000011011001100111101100100000111111111
11111111111111111111111111111111111111111111111111111111111
1111111111111111111111111111111111111111111111111111111111
11111111111110000000111111101110011001111110011111110000011
11000000000010000001000000000000011001100000000000000000111
110000000000000011100010101111101111001100000000011111111111
11000111111001001000110010001100000000000000100000000000011
11000100001001001001100110001100011111111100100111111111111
1110010010100111100110011000110001100100000S001000100010011
11000100100000000000000000001100000001101100100010001000111
1111111111111111111111111111111111111 11111111111111111111
